Grapheme	IPA
a	a
ai	ei
á	!á/a
á̃	!á̃/ã
ã	ã
ch	tʃ
e	ɨ
é̃	!é̃/ɨ̃
ẽ	ɨ̃
é	!é/ɨ
i	i
í̃	!í̃/ĩ
ĩ	ĩ
í	!í/i
j	h
k	k
m	m
n	n
ng	ŋ
p	p
r	r
s	s
sh	ʃ
t	t
ts	ts
u	u
ú	!ú/u
ú̃	!ú̃/ũ
ũ	ũ
w	w
wi	v i
y	j
pia	pʲ a
tia	tʲ a
kia	kʲ a
mia	mʲ a
nia	nʲ a
wia	wʲ a
niu	nʲ u