Grapheme	IPA
i	i
u	u
o	o
e	e
a	a
p	p
p'	pʼ
b	b
t	t
t'	tʼ
d	d
k	k
k'	kʼ
g	g
ʔ	ʔ
ts	ts
ch	tʃ
tʃ'	tʃʼ
s	s
ɬ	ɬ
sh	ʃ
h	h
m	m
n	n
l	l
r	ɾ
ll	ʎ
w	w
y	j
u'	u ʔ
hua	w a
hui	w i
x	h