Grapheme	IPA
a	a
aa	aː
à	!à/a
á	!á/a
i	i
ii	iː
ì	!ì/i
í	!í/i
ɨ̀	!ɨ̀/ɨ
ɨ	ɨ
ɨɨ	ɨː
ɨɨ́	!ɨɨ́/ɨː
ɨ́	!ɨ́/ɨ
u	u
uu	uː
ú	!ú/u
ù	!ù/u
j	h
k	k
kw	kʷ
kia	kʲ a
kiaa	kʲ aː
m	m
miaá	mʲ aː
n	n
ni	ɲ
p	p
r	r
s	s
siaa	ʃ aː
siáà	ʃ aː
t	t
w	w
y	j
ia	ja
iaa	jaː
-	+
-$	NULL
^-	NULL
=	+
=$	NULL
^=	NULL