Grapheme	IPA
p	p
ʼ	ʔ
#a	ʔa
a	a
ã	!ã/a
ai	aɪ
ãi	!ãĩ/aɪ
au	aʊ
ãu	!ãu/aʊ
b	b
ch	ʈɕ
d	d
e	e
ẽ	!ẽ/e
f	kʷ
g	g
ng̃	ŋ
i	i
ĩ	!ĩ/i
j	ɦ
k	k
m	m
n	n
ñ	ɲ
ng	ŋ
o	o
õ	!õ/o
ou	ou
p	p
r	ɾ
t	t
u	u
ũ	!ũ/u
ü	!ü/ɯ
ü̃	!ü̃/ɯ
w	w
w̃	!w̃/w
y	dʑ