Grapheme	IPA
o	o
ó	!ó/o
ʎ	ʎ
w	w
a	a
á	!á/a
e	e
é	!é/e
k	k
tʲ	tʲ
t͡ʃ	tʃ
ʃ	ʃ
pʲ	pʲ
ɾ	ɾ
aˀ	aˀ
t	t
eˀ	eˀ
s	s
ɲ	ɲ
p	p
ɽ	ɽ
j	j
n	n
m	m
tʂ	tʂ
pʼapoe	paˀpoeˀ
t͡ʂ	tʂ
ʀ	ʀ
oˀ	oˀ
mʷ	mʷ
pʷ	pʷ
oʰ	oʰ
aː	aː
mʲ	mʲ
ɻ	ɻ
ts	ts
ɨ	ɨ
ö	!ö/o
r	ɾ
ʎʷ	ʎʷ
βʲ	βʲ
ɪ	ɪ