Grapheme	IPA
a	a
i	i
ɨ	ɨ
u	u
o	o
aa	aː
ii	iː
ɨɨ	ɨː
uu	uː
ch	tʃ
m	m
n	n
p	p
r	r
s	s
t	t
y	j
h	h
hw	hʷ
k	k
kw	kʷ
ky	kʲ
ny	ɲ
ry	rʲ
sh	ʃ
ts	ts
w	w
hy	hʲ
ty	tʲ
ay$	ai
aym	ai m
ayt	ai t
aych	ai tʃ
aw$	au
awk	au k
awn	au n
aws	au s
awhw	au hʷ
awh	au h
awkw	au kʷ
-	+
-$	NULL
^-	NULL
=	+
=$	NULL
^=	NULL